Date,VaccineText,Dose1,Dose2,SingleDose,Dose1Cum,Dose2Cum,SingleDoseCum,PartiallyVacc,FullyVacc,PartialPercent,FullyPercent,ObjectId
28/12/2020,Mon 28 Dec 2020,195,20,0,195,20,0,195,20,0.004141088,0.000424727,338
29/12/2020,Tue 29 Dec 2020,74,2,0,269,22,0,269,22,0.005712578,0.0004672,339
30/12/2020,Wed 30 Dec 2020,1056,1,0,1325,23,0,1325,23,0.028138165,0.000488436,340
31/12/2020,Thu 31 Dec 2020,1031,1,0,2356,24,0,2356,24,0.050032842,0.000509672,341
01/01/2021,Fri 01 Jan 2021,812,0,1,3168,24,1,3169,25,0.067297995,0.000530909,342
02/01/2021,Sat 02 Jan 2021,1014,0,0,4182,24,1,4183,25,0.088831655,0.000530909,343
03/01/2021,Sun 03 Jan 2021,19,2,1,4201,26,2,4203,28,0.089256382,0.000594618,344
04/01/2021,Mon 04 Jan 2021,1187,3,0,5388,29,2,5390,31,0.11446393,0.000658327,345
05/01/2021,Tue 05 Jan 2021,3522,9,0,8910,38,2,8912,40,0.189258357,0.000849454,346
06/01/2021,Wed 06 Jan 2021,6769,8,0,15679,46,2,15681,48,0.333007214,0.001019345,347
07/01/2021,Thu 07 Jan 2021,11716,8,0,27395,54,2,27397,56,0.581812297,0.001189236,348
08/01/2021,Fri 08 Jan 2021,12674,5,0,40069,59,2,40071,61,0.850961805,0.001295417,349
09/01/2021,Sat 09 Jan 2021,8073,6,0,48142,65,2,48144,67,1.022402863,0.001422835,350
10/01/2021,Sun 10 Jan 2021,4776,3,1,52918,68,3,52921,71,1.12384891,0.001507781,351
11/01/2021,Mon 11 Jan 2021,8337,7,0,61255,75,3,61258,78,1.300896365,0.001656435,352
12/01/2021,Tue 12 Jan 2021,8876,9,0,70131,84,3,70134,87,1.489390213,0.001847563,353
13/01/2021,Wed 13 Jan 2021,9874,5,0,80005,89,3,80008,92,1.699077939,0.001953744,354
14/01/2021,Thu 14 Jan 2021,8073,4,0,88078,93,3,88081,96,1.870518997,0.00203869,355
15/01/2021,Fri 15 Jan 2021,7680,2,0,95758,95,3,95761,98,2.03361417,0.002081162,356
16/01/2021,Sat 16 Jan 2021,5224,3,0,100982,98,3,100985,101,2.144552865,0.002144871,357
17/01/2021,Sun 17 Jan 2021,1108,4,0,102090,102,3,102093,105,2.168082742,0.002229817,358
18/01/2021,Mon 18 Jan 2021,8703,7,0,110793,109,3,110796,112,2.352902701,0.002378471,359
19/01/2021,Tue 19 Jan 2021,8370,18,0,119163,127,3,119166,130,2.530650956,0.002760726,360
20/01/2021,Wed 20 Jan 2021,8441,961,0,127604,1088,3,127607,1091,2.709906991,0.023168859,361
21/01/2021,Thu 21 Jan 2021,8985,962,0,136589,2050,3,136592,2053,2.900715601,0.043598228,362
22/01/2021,Fri 22 Jan 2021,6767,967,0,143356,3017,3,143359,3020,3.044421986,0.064133779,363
23/01/2021,Sat 23 Jan 2021,4177,459,0,147533,3476,3,147536,3479,3.133126222,0.073881264,364
24/01/2021,Sun 24 Jan 2021,1181,397,0,148714,3873,3,148717,3876,3.158206352,0.082312095,365
25/01/2021,Mon 25 Jan 2021,1347,1286,0,150061,5159,3,150064,5162,3.186811717,0.109622042,366
26/01/2021,Tue 26 Jan 2021,998,3496,0,151059,8655,3,151062,8658,3.208005595,0.183864324,367
27/01/2021,Wed 27 Jan 2021,2161,6698,0,153220,15353,3,153223,15356,3.253897348,0.3261054,368
28/01/2021,Thu 28 Jan 2021,984,11537,0,154204,26890,3,154207,26893,3.274793917,0.571109177,369
29/01/2021,Fri 29 Jan 2021,1566,11525,0,155770,38415,3,155773,38418,3.308050042,0.815858117,370
30/01/2021,Sat 30 Jan 2021,622,7793,0,156392,46208,3,156395,46211,3.321259052,0.981352998,371
31/01/2021,Sun 31 Jan 2021,216,4088,0,156608,50296,3,156611,50299,3.325846104,1.068167199,372
01/02/2021,Mon 01 Feb 2021,1009,8336,0,157617,58632,3,157620,58635,3.347273582,1.245193417,373
02/02/2021,Tue 02 Feb 2021,823,5107,0,158440,63739,3,158443,63742,3.364751098,1.35364746,374
03/02/2021,Wed 03 Feb 2021,1390,6861,0,159830,70600,3,159833,70603,3.394269626,1.499350061,375
04/02/2021,Thu 04 Feb 2021,1414,10541,1,161244,81141,4,161248,81145,3.424319062,1.72322367,376
05/02/2021,Fri 05 Feb 2021,3377,8611,0,164621,89752,4,164625,89756,3.496034218,1.906089885,377
06/02/2021,Sat 06 Feb 2021,890,3866,0,165511,93618,4,165515,93622,3.51493457,1.988189616,378
07/02/2021,Sun 07 Feb 2021,322,1298,1,165833,94916,5,165838,94921,3.521793911,2.015775635,379
08/02/2021,Mon 08 Feb 2021,1158,878,0,166991,95794,5,166996,95799,3.546385605,2.034421151,380
09/02/2021,Tue 09 Feb 2021,4242,537,2,171233,96331,7,171240,96338,3.636512677,2.045867544,381
10/02/2021,Wed 10 Feb 2021,8814,579,0,180047,96910,7,180054,96917,3.823689871,2.058163391,382
11/02/2021,Thu 11 Feb 2021,6173,442,0,186220,97352,7,186227,97359,3.954781863,2.067549858,383
12/02/2021,Fri 12 Feb 2021,4384,522,0,190604,97874,7,190611,97881,4.047882024,2.078635233,384
13/02/2021,Sat 13 Feb 2021,1203,1913,0,191807,99787,7,191814,99794,4.073429354,2.119260372,385
14/02/2021,Sun 14 Feb 2021,2691,25,0,194498,99812,7,194505,99819,4.130576374,2.119791281,386
15/02/2021,Mon 15 Feb 2021,1955,7883,0,196453,107695,7,196460,107702,4.172093439,2.287197432,387
16/02/2021,Tue 16 Feb 2021,5633,8159,0,202086,115854,7,202093,115861,4.291717802,2.460464817,388
17/02/2021,Wed 17 Feb 2021,9729,8462,0,211815,124316,7,211822,124323,4.498326257,2.640166816,389
18/02/2021,Thu 18 Feb 2021,8452,8348,0,220267,132664,7,220274,132671,4.677815892,2.817447871,390
19/02/2021,Fri 19 Feb 2021,9384,6582,0,229651,139246,7,229658,139253,4.877097806,2.95722553,391
20/02/2021,Sat 20 Feb 2021,5884,3567,2,235535,142813,9,235544,142822,5.002094966,3.033018066,392
21/02/2021,Sun 21 Feb 2021,1106,1021,4,236641,143834,13,236654,143847,5.025667315,3.054785325,393
22/02/2021,Mon 22 Feb 2021,3936,1118,1,240577,144952,14,240591,144966,5.109274827,3.078548801,394
23/02/2021,Tue 23 Feb 2021,13353,1061,0,253930,146013,14,253944,146027,5.392843817,3.101080569,395
24/02/2021,Wed 24 Feb 2021,16927,2101,3,270857,148114,17,270874,148131,5.752375233,3.145761851,396
25/02/2021,Thu 25 Feb 2021,18079,1748,2,288936,149862,19,288955,149881,6.136349688,3.182925464,397
26/02/2021,Fri 26 Feb 2021,16083,2764,0,305019,152626,19,305038,152645,6.477893915,3.241622738,398
27/02/2021,Sat 27 Feb 2021,8986,703,1,314005,153329,20,314025,153349,6.668744998,3.256573128,399
28/02/2021,Sun 28 Feb 2021,2440,51,1,316445,153380,21,316466,153401,6.720582929,3.257677419,400
01/03/2021,Mon 01 Mar 2021,5580,785,0,322025,154165,21,322046,154186,6.839081766,3.274347954,401
02/03/2021,Tue 02 Mar 2021,12172,1604,0,334197,155769,21,334218,155790,7.097570625,3.30841106,402
03/03/2021,Wed 03 Mar 2021,12884,1501,1,347081,157270,22,347103,157292,7.371201003,3.340308059,403
04/03/2021,Thu 04 Mar 2021,18722,1686,3,365803,158956,25,365828,158981,7.768851668,3.376176255,404
05/03/2021,Fri 05 Mar 2021,18432,2391,6,384235,161347,31,384266,161378,8.1604075,3.427079787,405
06/03/2021,Sat 06 Mar 2021,10446,135,4,394681,161482,35,394716,161517,8.382327364,3.43003164,406
07/03/2021,Sun 07 Mar 2021,1513,10,2,396194,161492,37,396231,161529,8.414500435,3.430286476,407
08/03/2021,Mon 08 Mar 2021,6656,1493,4,402850,162985,41,402891,163026,8.55593453,3.462077293,408
09/03/2021,Tue 09 Mar 2021,13810,3100,5,416660,166085,46,416706,166131,8.849314714,3.528016162,409
10/03/2021,Wed 10 Mar 2021,13716,3979,3,430376,170064,49,430425,170113,9.140656207,3.61257931,410
11/03/2021,Thu 11 Mar 2021,18462,2096,3,448838,172160,52,448890,172212,9.532785421,3.65715441,411
12/03/2021,Fri 12 Mar 2021,17314,1332,3,466152,173492,55,466207,173547,9.900535305,3.685504938,412
13/03/2021,Sat 13 Mar 2021,8290,172,0,474442,173664,55,474497,173719,10.07658465,3.68915759,413
14/03/2021,Sun 14 Mar 2021,374,17,1,474816,173681,56,474872,173737,10.08454828,3.689539844,414
15/03/2021,Mon 15 Mar 2021,2639,987,0,477455,174668,56,477511,174724,10.14059101,3.710500122,415
16/03/2021,Tue 16 Mar 2021,8925,3814,2,486380,178482,58,486438,178540,10.33016791,3.791538036,416
17/03/2021,Wed 17 Mar 2021,4878,2415,6,491258,180897,64,491322,180961,10.43388625,3.842951241,417
18/03/2021,Thu 18 Mar 2021,11707,4678,3,502965,185575,67,503032,185642,10.68256392,3.942358598,418
19/03/2021,Fri 19 Mar 2021,10350,6120,2,513315,191695,69,513384,191764,10.90240262,4.072367537,419
20/03/2021,Sat 20 Mar 2021,5224,3116,2,518539,194811,71,518610,194882,11.01338379,4.138582478,420
21/03/2021,Sun 21 Mar 2021,3628,53,3,522167,194864,74,522241,194938,11.09049297,4.139771713,421
22/03/2021,Mon 22 Mar 2021,7390,2397,1,529557,197261,75,529632,197336,11.24745084,4.190696482,422
23/03/2021,Tue 23 Mar 2021,12559,7382,3,542116,204643,78,542194,204721,11.51422188,4.347526931,423
24/03/2021,Wed 24 Mar 2021,13606,9779,1,555722,214422,79,555801,214501,11.8031849,4.55521844,424
25/03/2021,Thu 25 Mar 2021,20849,10218,3,576571,224640,82,576653,224722,12.24600528,4.77227518,425
26/03/2021,Fri 26 Mar 2021,19688,9493,1,596259,234133,83,596342,234216,12.66412779,4.973893092,426
27/03/2021,Sat 27 Mar 2021,11723,5341,2,607982,239474,85,608067,239559,12.913124,5.087358914,427
28/03/2021,Sun 28 Mar 2021,2479,480,0,610461,239954,85,610546,240039,12.96576891,5.097552362,428
29/03/2021,Tue 30 Mar 2021,13313,8658,4,633018,251724,92,633110,251816,13.44494593,5.347652863,430
30/03/2021,Wed 31 Mar 2021,15806,10502,3,648824,262226,95,648919,262321,13.7806714,5.570740726,431
31/03/2021,Thu 01 Apr 2021,19666,11621,7,668490,273847,102,668592,273949,14.19845412,5.817677011,432
01/04/2021,Fri 02 Apr 2021,20114,13717,7,688604,287564,109,688713,287673,14.62575073,6.109124686,433
02/04/2021,Sat 03 Apr 2021,7532,4648,5,696136,292212,114,696250,292326,14.78580911,6.207937426,434
03/04/2021,Sun 04 Apr 2021,3016,167,3,699152,292379,117,699269,292496,14.84992165,6.211547605,435
04/04/2021,Mon 05 Apr 2021,3415,600,4,702567,292979,121,702688,293100,14.92252873,6.224374361,436
05/04/2021,Tue 06 Apr 2021,11967,8157,10,714534,301136,131,714665,301267,15.1768765,6.397811637,437
06/04/2021,Wed 07 Apr 2021,18329,10456,8,732863,311592,139,733002,311731,15.56628746,6.620028809,438
07/04/2021,Thu 08 Apr 2021,20160,10566,14,753023,322158,153,753176,322311,15.9947096,6.844709399,439
08/04/2021,Fri 09 Apr 2021,20676,9153,16,773699,331311,169,773868,331480,16.43413217,7.039425497,440
09/04/2021,Sat 10 Apr 2021,11146,4155,12,784845,335466,181,785026,335647,16.67108737,7.12791737,441
10/04/2021,Sun 11 Apr 2021,2847,352,6,787692,335818,187,787879,336005,16.73167468,7.135519984,442
11/04/2021,Mon 12 Apr 2021,7753,2777,11,795445,338595,198,795643,338793,16.8965537,7.194726929,443
12/04/2021,Tue 13 Apr 2021,11485,8588,1,806930,347183,199,807129,347382,17.14047442,7.377125945,444
13/04/2021,Wed 14 Apr 2021,20328,6586,2,827258,353769,201,827459,353970,17.57220943,7.517031022,445
14/04/2021,Thu 15 Apr 2021,27110,10784,1,854368,364553,202,854570,364755,18.14794813,7.746065064,446
15/04/2021,Fri 16 Apr 2021,27963,9825,1,882331,374378,203,882534,374581,18.74180144,7.954733445,447
16/04/2021,Sat 17 Apr 2021,15838,4542,2,898169,378920,205,898374,379125,19.07818523,8.051231422,448
17/04/2021,Sun 18 Apr 2021,1061,474,0,899230,379394,205,899435,379599,19.100717,8.061297452,449
18/04/2021,Mon 19 Apr 2021,6726,2243,0,905956,381637,205,906161,381842,19.2435527,8.108930586,450
19/04/2021,Tue 20 Apr 2021,15064,7296,1,921020,388933,206,921226,389139,19.56347832,8.263892237,112
20/04/2021,Wed 21 Apr 2021,26692,9866,3,947712,398799,209,947921,399008,20.1303827,8.473473781,113
21/04/2021,Thu 22 Apr 2021,31611,12177,1,979323,410976,210,979533,411186,20.80170621,8.732090058,114
22/04/2021,Fri 23 Apr 2021,33574,12359,1,1012897,423335,211,1013108,423546,21.51471668,8.994571352,115
23/04/2021,Sat 24 Apr 2021,23687,6979,2,1036584,430314,213,1036797,430527,22.01778459,9.142822315,116
24/04/2021,Sun 25 Apr 2021,9731,295,2,1046315,430609,215,1046530,430824,22.22447799,9.149129511,117
25/04/2021,Mon 26 Apr 2021,15551,3037,3,1061866,433646,218,1062084,433864,22.55478819,9.213688017,118
26/04/2021,Tue 27 Apr 2021,25894,7800,8,1087760,441446,226,1087986,441672,23.10485215,9.379501443,119
27/04/2021,Wed 28 Apr 2021,26013,8584,5,1113773,450030,231,1114004,450261,23.65737952,9.561900458,120
28/04/2021,Thu 29 Apr 2021,31669,11331,5,1145442,461361,236,1145678,461597,24.33001968,9.802635728,121
29/04/2021,Fri 30 Apr 2021,36105,13511,8,1181547,474872,244,1181791,475116,25.09692801,10.08972995,122
30/04/2021,Sat 01 May 2021,16535,6679,17,1198082,481551,261,1198343,481812,25.44843209,10.23192856,123
01/05/2021,Sun 02 May 2021,12419,901,13,1210501,482452,274,1210775,482726,25.7124424,10.25133858,124
02/05/2021,Mon 03 May 2021,14238,911,17,1224739,483363,291,1225030,483654,26.01516658,10.27104591,125
03/05/2021,Tue 04 May 2021,26620,6768,9,1251359,490131,300,1251659,490431,26.58066936,10.41496466,126
04/05/2021,Wed 05 May 2021,32069,13437,68,1283428,503568,368,1283796,503936,27.26314196,10.70176158,127
05/05/2021,Thu 06 May 2021,37250,14368,132,1320678,517936,500,1321178,518436,28.05699921,11.00968866,128
06/05/2021,Fri 07 May 2021,40570,15060,94,1361248,532996,594,1361842,533590,28.92055418,11.33150432,129
07/05/2021,Sat 08 May 2021,25580,7029,10,1386828,540025,604,1387432,540629,29.46399239,11.48098699,130
08/05/2021,Sun 09 May 2021,19641,914,2,1406469,540939,606,1407075,541545,29.88113802,11.50043949,131
09/05/2021,Mon 10 May 2021,28794,4625,171,1435263,545564,777,1436040,546341,30.49624892,11.60228902,132
10/05/2021,Tue 11 May 2021,33902,14805,150,1469165,560369,927,1470092,561296,31.21938913,11.91987865,133
11/05/2021,Wed 12 May 2021,31256,20925,167,1500421,581294,1094,1501515,582388,31.88669897,12.36779575,134
12/05/2021,Thu 13 May 2021,35958,25477,150,1536379,606771,1244,1537623,608015,32.65350112,12.91201971,135
13/05/2021,Fri 14 May 2021,38173,27959,234,1574552,634730,1478,1576030,636208,33.46912564,13.51073614,136
14/05/2021,Sat 15 May 2021,28819,12431,19,1603371,647161,1497,1604868,648658,34.08153952,13.77512871,137
15/05/2021,Sun 16 May 2021,23142,1156,9,1626513,648317,1506,1628019,649823,34.57318227,13.79986906,138
16/05/2021,Mon 17 May 2021,35357,3930,112,1661870,652247,1618,1663488,653865,35.32641439,13.88570639,139
17/05/2021,Tue 18 May 2021,39006,12477,122,1700876,664724,1740,1702616,666464,36.15735032,14.15326317,140
18/05/2021,Wed 19 May 2021,36986,17582,203,1737862,682306,1943,1739805,684249,36.94710896,14.53095166,141
19/05/2021,Thu 20 May 2021,39047,19657,131,1776909,701963,2074,1778983,704037,37.7791067,14.95117657,142
20/05/2021,Fri 21 May 2021,25789,23233,14930,1802698,725196,17004,1819702,742200,38.64382966,15.76161942,143
21/05/2021,Sat 22 May 2021,16551,10244,13519,1819249,735440,30523,1849772,765963,39.28240672,16.26625882,144
22/05/2021,Sun 23 May 2021,8188,5514,10202,1827437,740954,40725,1868162,781679,39.67294321,16.6000093,145
23/05/2021,Mon 24 May 2021,22497,8199,8446,1849934,749153,49171,1899105,798324,40.33005961,16.95348836,146
24/05/2021,Tue 25 May 2021,30273,16502,3220,1880207,765655,52391,1932598,818046,41.0413287,17.37231166,147
25/05/2021,Wed 26 May 2021,19922,25419,3048,1900129,791074,55439,1955568,846513,41.52912767,17.97684686,148
26/05/2021,Thu 27 May 2021,16961,35998,550,1917090,827072,55989,1973079,883061,41.90099741,18.752993,149
27/05/2021,Fri 28 May 2021,26973,31806,1553,1944063,858878,57542,2001605,916420,42.50678554,19.46141642,150
28/05/2021,Sat 29 May 2021,24418,7374,532,1968481,866252,58074,2026555,924326,43.03663249,19.62931101,151
29/05/2021,Sun 30 May 2021,24196,1663,207,1992677,867915,58281,2050958,926196,43.55486316,19.66902298,152
30/05/2021,Mon 31 May 2021,22517,7310,3436,2015194,875225,61717,2076911,936942,44.10601016,19.8972288,153
31/05/2021,Tue 01 Jun 2021,27460,11491,3644,2042654,886716,65361,2108015,952077,44.76654561,20.21864097,154
01/06/2021,Wed 02 Jun 2021,18623,20874,3997,2061277,907590,69358,2130635,976948,45.24691186,20.74681025,155
02/06/2021,Thu 03 Jun 2021,16618,30693,1970,2077895,938283,71328,2149223,1009611,45.64165315,21.44045317,156
03/06/2021,Fri 04 Jun 2021,28957,23333,148,2106852,961616,71476,2178328,1033092,46.25973713,21.93910392,157
04/06/2021,Sat 05 Jun 2021,20901,11469,32,2127753,973085,71508,2199261,1044593,46.70427766,22.18334318,158
05/06/2021,Sun 06 Jun 2021,19891,3885,38,2147644,976970,71546,2219190,1048516,47.12749689,22.26665339,159
06/06/2021,Mon 07 Jun 2021,19743,4552,36,2167387,981522,71582,2238969,1053104,47.54753067,22.36408576,160
07/06/2021,Tue 08 Jun 2021,26367,18327,39,2193754,999849,71621,2265375,1071470,48.10829774,22.75411258,161
08/06/2021,Wed 09 Jun 2021,32721,20079,168,2226475,1019928,71789,2298264,1091717,48.80674008,23.18408497,162
09/06/2021,Thu 10 Jun 2021,27614,27458,266,2254089,1047386,72055,2326144,1119441,49.39880953,23.77284155,163
10/06/2021,Fri 11 Jun 2021,26376,32868,36,2280465,1080254,72091,2352556,1152345,49.95970402,24.47160243,164
11/06/2021,Sat 12 Jun 2021,12156,19695,101,2292621,1099949,72192,2364813,1172141,50.21999797,24.89199723,165
12/06/2021,Sun 13 Jun 2021,8516,18154,829,2301137,1118103,73021,2374158,1191124,50.41845167,25.29512687,166
13/06/2021,Mon 14 Jun 2021,15967,31272,43,2317104,1149375,73064,2390168,1222439,50.75844564,25.96014319,167
14/06/2021,Tue 15 Jun 2021,14640,41532,200,2331744,1190907,73264,2405008,1264171,51.07359309,26.84637858,168
15/06/2021,Wed 16 Jun 2021,13393,48357,209,2345137,1239264,73473,2418610,1312737,51.36244993,27.87774318,169
16/06/2021,Thu 17 Jun 2021,21525,42637,532,2366662,1281901,74005,2440667,1355906,51.83086011,28.7944952,170
17/06/2021,Fri 18 Jun 2021,11966,50016,545,2378628,1331917,74550,2453178,1406467,52.09654809,29.86822632,171
18/06/2021,Sat 19 Jun 2021,6263,32760,430,2384891,1364677,74980,2459871,1439657,52.23868299,30.5730608,172
19/06/2021,Sun 20 Jun 2021,8474,26116,172,2393365,1390793,75152,2468517,1465945,52.42229248,31.13132198,173
20/06/2021,Mon 21 Jun 2021,15414,32288,563,2408779,1423081,75715,2484494,1498796,52.76158565,31.82895734,174
21/06/2021,Tue 22 Jun 2021,15084,43500,713,2423863,1466581,76428,2500291,1543009,53.09705628,32.7678801,175
22/06/2021,Wed 23 Jun 2021,20027,39345,876,2443890,1505926,77304,2521194,1583230,53.54095972,33.62202736,176
23/06/2021,Thu 24 Jun 2021,18965,44219,1028,2462855,1550145,78332,2541187,1628477,53.96553807,34.58290852,177
24/06/2021,Fri 25 Jun 2021,15149,50091,826,2478004,1600236,79158,2557162,1679394,54.30478878,35.66419978,178
25/06/2021,Sat 26 Jun 2021,9000,30511,490,2487004,1630747,79648,2566652,1710395,54.50632174,36.32254789,179
26/06/2021,Sun 27 Jun 2021,8691,30441,51,2495695,1661188,79699,2575394,1740887,54.69196992,36.97008669,180
27/06/2021,Mon 28 Jun 2021,24169,24593,511,2519864,1685781,80210,2600074,1765991,55.21608305,37.50320403,181
28/06/2021,Tue 29 Jun 2021,28093,30962,802,2547957,1716743,81012,2628969,1797755,55.8297074,38.17775547,182
29/06/2021,Wed 30 Jun 2021,22494,36816,568,2570451,1753559,81580,2652031,1835139,56.31946012,38.97165521,183
30/06/2021,Thu 01 Jul 2021,14902,48267,628,2585353,1801826,82208,2667561,1884034,56.64926065,40.01000657,184
01/07/2021,Fri 02 Jul 2021,13589,47200,811,2598942,1849026,83019,2681961,1932045,56.95506409,41.029585,185
02/07/2021,Sat 03 Jul 2021,9261,30424,497,2608203,1879450,83516,2691719,1962966,57.1622884,41.68623419,186
03/07/2021,Sun 04 Jul 2021,6400,27746,227,2614603,1907196,83743,2698346,1990939,57.3030217,42.28027863,187
04/07/2021,Mon 05 Jul 2021,15513,33374,5328,2630116,1940570,89071,2719187,2029641,57.74560848,43.10216787,188
05/07/2021,Tue 06 Jul 2021,12330,48293,5477,2642446,1988863,94548,2736994,2083411,58.12376418,44.24404644,189
06/07/2021,Wed 07 Jul 2021,19630,43699,5044,2662076,2032562,99592,2761668,2132154,58.64774989,45.27916988,190
07/07/2021,Thu 08 Jul 2021,17692,45532,5984,2679768,2078094,105576,2785344,2183670,59.15054173,46.37318172,191
08/07/2021,Fri 09 Jul 2021,13464,45042,6517,2693232,2123136,112093,2805325,2235229,59.57486525,47.46810672,192
09/07/2021,Sat 10 Jul 2021,8572,23805,4354,2701804,2146941,116447,2818251,2263388,59.84936632,48.06610111,193
10/07/2021,Sun 11 Jul 2021,15191,16075,2148,2716995,2163016,118595,2835590,2281611,60.2175834,48.45309113,194
11/07/2021,Mon 12 Jul 2021,17052,31676,6079,2734047,2194692,124674,2858721,2319366,60.70880143,49.25486955,195
12/07/2021,Tue 13 Jul 2021,20038,36491,8477,2754085,2231183,133151,2887236,2364334,61.31435596,50.20982576,196
13/07/2021,Wed 14 Jul 2021,20732,35622,9319,2774817,2266805,142470,2917287,2409275,61.95252954,51.16420859,197
14/07/2021,Thu 15 Jul 2021,23558,28768,9562,2798375,2295573,152032,2950407,2447605,62.65587747,51.97819791,198
15/07/2021,Fri 16 Jul 2021,23486,27346,9155,2821861,2322919,161187,2983048,2484106,63.34905319,52.75334595,199
16/07/2021,Sat 17 Jul 2021,11452,19375,4669,2833313,2342294,165856,2999169,2508150,63.6914044,53.26395276,200
17/07/2021,Sun 18 Jul 2021,16819,15761,1922,2850132,2358055,167778,3017910,2525833,64.08939484,53.63947515,201
18/07/2021,Mon 19 Jul 2021,24822,18338,6232,2874954,2376393,174010,3048964,2550403,64.74886847,54.16125228,202
19/07/2021,Tue 20 Jul 2021,30512,18088,7687,2905466,2394481,181697,3087163,2576178,65.56007583,54.70861922,203
20/07/2021,Wed 21 Jul 2021,30285,19756,6875,2935751,2414237,188572,3124323,2602809,66.34921862,55.27416447,204
21/07/2021,Thu 22 Jul 2021,33474,15847,6924,2969225,2430084,195496,3164721,2625580,67.20712471,55.75773741,205
22/07/2021,Fri 23 Jul 2021,27033,20741,5602,2996258,2450825,201098,3197356,2651923,67.90017301,56.3171666,206
23/07/2021,Sat 24 Jul 2021,15396,14742,2261,3011654,2465567,203359,3215013,2668926,68.27514326,56.67824826,207
24/07/2021,Sun 25 Jul 2021,14679,13592,1031,3026333,2479159,204390,3230723,2683549,68.60876632,56.98878742,208
25/07/2021,Mon 26 Jul 2021,23775,18190,3404,3050108,2497349,207794,3257902,2705143,69.1859491,57.44736517,209
26/07/2021,Tue 27 Jul 2021,25430,23787,3657,3075538,2521136,211451,3286989,2732587,69.80365083,58.03017558,210
27/07/2021,Wed 28 Jul 2021,23381,25194,3249,3098919,2546330,214700,3313619,2761030,70.36917484,58.6342011,211
28/07/2021,Thu 29 Jul 2021,19204,27783,2950,3118123,2574113,217650,3335773,2791763,70.83964495,59.28685786,212
29/07/2021,Fri 30 Jul 2021,21885,22846,2109,3140008,2596959,219759,3359767,2816718,71.34918995,59.81681099,213
30/07/2021,Sat 31 Jul 2021,13697,12402,900,3153705,2609361,220659,3374364,2830020,71.65917696,60.09929693,214
31/07/2021,Sun 01 Aug 2021,11058,9259,364,3164763,2618620,221023,3385786,2839643,71.90173856,60.30365433,215
01/08/2021,Mon 02 Aug 2021,14962,15920,420,3179725,2634540,221443,3401168,2855983,72.2283961,60.6506563,216
02/08/2021,Tue 03 Aug 2021,17289,25361,1103,3197014,2659901,222546,3419560,2882447,72.61897506,61.21265508,217
03/08/2021,Wed 04 Aug 2021,22056,17199,1570,3219070,2677100,224116,3443186,2901216,73.12070508,61.61124015,218
04/08/2021,Thu 05 Aug 2021,13476,29948,1417,3232546,2707048,225533,3458079,2932581,73.43697805,62.27731828,219
05/08/2021,Fri 06 Aug 2021,12141,24667,941,3244687,2731715,226474,3471161,2958189,73.71479199,62.82113875,220
06/08/2021,Sat 07 Aug 2021,6308,8387,578,3250995,2740102,227052,3478047,2967154,73.8610255,63.01152263,221
07/08/2021,Sun 08 Aug 2021,8591,11916,153,3259586,2752018,227205,3486791,2979223,74.04671615,63.26782415,222
08/08/2021,Mon 09 Aug 2021,5503,22938,597,3265089,2774956,227802,3492891,3002758,74.17625789,63.76762166,223
09/08/2021,Tue 10 Aug 2021,9295,25912,707,3274384,2800868,228509,3502893,3029377,74.38866387,64.33291207,224
10/08/2021,Wed 11 Aug 2021,6970,31144,653,3281354,2832012,229162,3510516,3061174,74.55054857,65.00816431,225
11/08/2021,Thu 12 Aug 2021,6723,38210,857,3288077,2870222,230019,3518096,3100241,74.7115201,65.83780482,226
12/08/2021,Fri 13 Aug 2021,10875,28167,860,3298952,2898389,230879,3529831,3129268,74.96072868,66.45423237,227
13/08/2021,Sat 14 Aug 2021,18095,5796,277,3317047,2904185,231156,3548203,3135341,75.35088291,66.58320073,228
14/08/2021,Sun 15 Aug 2021,16977,3691,46,3334024,2907876,231202,3565226,3139078,75.71238931,66.66256097,229
15/08/2021,Mon 16 Aug 2021,10151,23067,379,3344175,2930943,231581,3575756,3162524,75.93600808,67.16046845,230
16/08/2021,Tue 17 Aug 2021,12853,26807,523,3357028,2957750,232104,3589132,3189854,76.22006551,67.74085791,231
17/08/2021,Wed 18 Aug 2021,15189,25713,654,3372217,2983463,232758,3604975,3216221,76.55651301,68.30079677,232
18/08/2021,Thu 19 Aug 2021,11337,25627,537,3383554,3009090,233295,3616849,3242385,76.80867344,68.85642464,233
19/08/2021,Fri 20 Aug 2021,14814,22176,683,3398368,3031266,233978,3632346,3265244,77.13777316,69.34186638,234
20/08/2021,Sat 21 Aug 2021,11847,7924,240,3410215,3039190,234218,3644433,3273408,77.39445693,69.51523995,235
21/08/2021,Sun 22 Aug 2021,7994,12218,160,3418209,3051408,234378,3652587,3285786,77.56761813,69.7781035,236
22/08/2021,Mon 23 Aug 2021,10841,15313,284,3429050,3066721,234662,3663712,3301383,77.80387253,70.10932686,237
23/08/2021,Tue 24 Aug 2021,9724,22869,382,3438774,3089590,235044,3673818,3324634,78.01848709,70.60309324,238
24/08/2021,Wed 25 Aug 2021,9394,19453,310,3448168,3109043,235354,3683522,3344397,78.22456464,71.02278724,239
25/08/2021,Thu 26 Aug 2021,8555,19369,363,3456723,3128412,235717,3692440,3364129,78.41395041,71.44182291,240
26/08/2021,Fri 27 Aug 2021,9695,19145,430,3466418,3147557,236147,3702565,3383704,78.62896846,71.85752447,241
27/08/2021,Sat 28 Aug 2021,9906,7866,152,3476324,3155423,236299,3712623,3391722,78.84256368,72.02779753,242
28/08/2021,Sun 29 Aug 2021,8789,9165,28,3485113,3164588,236327,3721440,3400915,79.02980458,72.2230233,243
29/08/2021,Mon 30 Aug 2021,5038,11064,80,3490151,3175652,236407,3726558,3412059,79.13849222,72.4596812,244
30/08/2021,Tue 31 Aug 2021,4045,12816,140,3494196,3188468,236547,3730743,3425015,79.22736635,72.73481935,245
31/08/2021,Wed 01 Sep 2021,4928,12487,179,3499124,3200955,236726,3735850,3437681,79.33582039,73.00379897,246
01/09/2021,Thu 02 Sep 2021,4995,12313,246,3504119,3213268,236972,3741091,3450240,79.44712011,73.2705063,247
02/09/2021,Fri 03 Sep 2021,4749,16012,163,3508868,3229280,237135,3746003,3466415,79.55143306,73.61400427,248
03/09/2021,Sat 04 Sep 2021,4617,10544,132,3513485,3239824,237267,3750752,3477091,79.65228449,73.84072355,249
04/09/2021,Sun 05 Sep 2021,5303,11877,1,3518788,3251701,237268,3756056,3488969,79.76492209,74.09296892,250
05/09/2021,Mon 06 Sep 2021,2142,9641,77,3520930,3261342,237345,3758275,3498687,79.81204556,74.29934378,251
06/09/2021,Tue 07 Sep 2021,3022,9967,153,3523952,3271309,237498,3761450,3508807,79.87947097,74.51425564,252
07/09/2021,Wed 08 Sep 2021,2587,14768,185,3526539,3286077,237683,3764222,3523760,79.93833813,74.83180279,253
08/09/2021,Thu 09 Sep 2021,3104,14761,137,3529643,3300838,237820,3767463,3538658,80.00716514,75.14818195,254
09/09/2021,Fri 10 Sep 2021,3362,13917,115,3533005,3314755,237935,3770940,3552690,80.08100394,75.44617042,255
10/09/2021,Sat 11 Sep 2021,2547,11298,62,3535552,3326053,237997,3773549,3564050,80.13640957,75.68741536,256
11/09/2021,Sun 12 Sep 2021,2031,12864,1,3537583,3338917,237998,3775581,3576915,80.17956184,75.96062101,257
12/09/2021,Mon 13 Sep 2021,1597,7704,50,3539180,3346621,238048,3777228,3584669,80.21453811,76.12528767,258
13/09/2021,Tue 14 Sep 2021,1535,10750,81,3540715,3357371,238129,3778844,3595500,80.24885605,76.35529859,259
14/09/2021,Wed 15 Sep 2021,3267,12372,136,3543982,3369743,238265,3782247,3608008,80.32112335,76.62092286,260
15/09/2021,Thu 16 Sep 2021,1894,10572,113,3545876,3380315,238378,3784254,3618693,80.36374471,76.84783327,261
16/09/2021,Fri 17 Sep 2021,2554,14589,92,3548430,3394904,238470,3786900,3633374,80.41993609,77.15960413,262
17/09/2021,Sat 18 Sep 2021,2277,11210,43,3550707,3406114,238513,3789220,3644627,80.46920442,77.39857678,263
18/09/2021,Sun 19 Sep 2021,1856,8483,13,3552563,3414597,238526,3791089,3653123,80.50889516,77.57900082,264
19/09/2021,Mon 20 Sep 2021,945,5594,33,3553508,3420191,238559,3792067,3658750,80.52966431,77.69849776,265
20/09/2021,Tue 21 Sep 2021,1458,6645,90,3554966,3426836,238649,3793615,3665485,80.56253819,77.84152458,266
21/09/2021,Wed 22 Sep 2021,1890,8119,96,3556856,3434955,238745,3795601,3673700,80.60471358,78.0159812,267
22/09/2021,Thu 23 Sep 2021,1690,8740,88,3558546,3443695,238833,3797379,3682528,80.64247181,78.20345571,268
23/09/2021,Fri 24 Sep 2021,1904,7366,79,3560450,3451061,238912,3799362,3689973,80.68458349,78.36156034,269
24/09/2021,Sat 25 Sep 2021,2410,6571,51,3562860,3457632,238963,3801823,3696595,80.73684615,78.50218745,270
25/09/2021,Sun 26 Sep 2021,1537,7089,0,3564397,3464721,238963,3803360,3703684,80.76948642,78.65273194,271
26/09/2021,Mon 27 Sep 2021,1168,3773,45,3565565,3468494,239008,3804573,3707502,80.79524612,78.73381233,272
27/09/2021,Tue 28 Sep 2021,1441,5103,91,3567006,3473597,239099,3806105,3712696,80.8277802,78.84411393,273
28/09/2021,Wed 29 Sep 2021,1643,3593,77,3568649,3477190,239176,3807825,3716366,80.86430673,78.92205134,274
29/09/2021,Thu 30 Sep 2021,1279,3935,77,3569928,3481125,239253,3809181,3720378,80.89310322,79.00725158,275
30/09/2021,Fri 01 Oct 2021,1838,5147,41,3571766,3486272,239294,3811060,3725566,80.93300632,79.11742576,276
01/10/2021,Sat 02 Oct 2021,1705,4070,40,3573471,3490342,239334,3812805,3729676,80.97006375,79.20470716,277
02/10/2021,Sun 03 Oct 2021,1194,3005,9,3574665,3493347,239343,3814008,3732690,80.99561108,79.26871353,278
03/10/2021,Mon 04 Oct 2021,334,1214,19,3574999,3494561,239362,3814361,3733923,81.00310752,79.29489795,279
04/10/2021,Tue 05 Oct 2021,960,2804,69,3575959,3497365,239431,3815390,3736796,81.02495972,79.35590998,280
05/10/2021,Wed 06 Oct 2021,970,2541,35,3576929,3499906,239466,3816395,3739372,81.04630225,79.41061482,281
06/10/2021,Thu 07 Oct 2021,1202,2669,44,3578131,3502575,239510,3817641,3742085,81.07276275,79.46822904,282
07/10/2021,Fri 08 Oct 2021,974,2762,45,3579105,3505337,239555,3818660,3744892,81.09440259,79.52783948,283
08/10/2021,Sat 09 Oct 2021,728,2358,23,3579833,3507695,239578,3819411,3747273,81.11035109,79.57840323,284
09/10/2021,Sun 10 Oct 2021,1499,3904,1,3581332,3511599,239579,3820911,3751178,81.14220561,79.66133118,285
10/10/2021,Mon 11 Oct 2021,330,1099,15,3581662,3512698,239594,3821256,3752292,81.14953215,79.68498847,286
11/10/2021,Tue 12 Oct 2021,562,1586,20,3582224,3514284,239614,3821838,3753898,81.16189171,79.71909405,287
12/10/2021,Wed 13 Oct 2021,1019,2031,9,3583243,3516315,239623,3822866,3755938,81.18372268,79.7624162,288
13/10/2021,Thu 14 Oct 2021,689,1562,7,3583932,3517877,239630,3823562,3757507,81.19850318,79.79573604,289
14/10/2021,Fri 15 Oct 2021,954,2045,7,3584886,3519922,239637,3824523,3759559,81.21891131,79.83931303,290
15/10/2021,Sat 16 Oct 2021,1373,2615,13,3586259,3522537,239650,3825909,3762187,81.24834489,79.89512216,291
16/10/2021,Sun 17 Oct 2021,1697,2882,2,3587956,3525419,239652,3827608,3765071,81.28442545,79.95636779,292
17/10/2021,Mon 18 Oct 2021,667,1214,4,3588623,3526633,239656,3828279,3766289,81.29867504,79.98223367,293
18/10/2021,Tue 19 Oct 2021,1330,1770,12,3589953,3528403,239668,3829621,3768071,81.32717423,80.02007685,294
19/10/2021,Wed 20 Oct 2021,2243,2287,0,3592196,3530690,239668,3831864,3770358,81.37480736,80.06864438,295
20/10/2021,Thu 21 Oct 2021,1750,1799,10,3593946,3532489,239678,3833624,3772167,81.41218334,80.10706094,296
21/10/2021,Fri 22 Oct 2021,1491,1899,2,3595437,3534388,239680,3835117,3774068,81.44388921,80.14743124,297
22/10/2021,Sat 23 Oct 2021,2008,1674,1,3597445,3536062,239681,3837126,3775743,81.48655304,80.18300213,298
23/10/2021,Sun 24 Oct 2021,1943,2179,2,3599388,3538241,239683,3839071,3777924,81.52785774,80.22931861,299
24/10/2021,Mon 25 Oct 2021,1215,824,2,3600603,3539065,239685,3840288,3778750,81.55370238,80.24685983,300
25/10/2021,Tue 26 Oct 2021,1235,1192,6,3601838,3540257,239691,3841529,3779948,81.58005669,80.27230098,301
26/10/2021,Wed 27 Oct 2021,1550,1398,5,3603388,3541655,239696,3843084,3781351,81.61307921,80.30209558,302
27/10/2021,Thu 28 Oct 2021,2145,1668,3,3605533,3543323,239699,3845232,3783022,81.65869489,80.33758152,303
28/10/2021,Fri 29 Oct 2021,2132,1340,0,3607665,3544663,239699,3847364,3784362,81.70397079,80.36603823,304
29/10/2021,Sat 30 Oct 2021,2008,1431,0,3609673,3546094,239699,3849372,3785793,81.74661339,80.39642745,305
30/10/2021,Sun 31 Oct 2021,1624,1314,0,3611297,3547408,239699,3850996,3787107,81.78110122,80.42433202,306
01/11/2021,Mon 01 Nov 2021,262,262,2,3611559,3547670,239701,3851260,3787371,81.78670762,80.42993841,307
02/11/2021,Tue 02 Nov 2021,1089,1074,9,3612648,3548744,239710,3852358,3788454,81.81002513,80.45293738,308
03/11/2021,Wed 03 Nov 2021,2532,1836,5,3615180,3550580,239715,3854895,3790295,81.86390175,80.4920335,309
04/11/2021,Thu 04 Nov 2021,1542,1250,1,3616722,3551830,239716,3856438,3791546,81.89666944,80.51860018,310
05/11/2021,Fri 05 Nov 2021,1627,1060,2,3618349,3552890,239718,3858067,3792608,81.93126345,80.54115318,311
06/11/2021,Sat 06 Nov 2021,1818,1337,5,3620167,3554227,239723,3859890,3793950,81.96997732,80.56965236,312
07/11/2021,Sun 07 Nov 2021,725,765,0,3620892,3554992,239723,3860615,3794715,81.98537368,80.58589817,313
08/11/2021,Mon 08 Nov 2021,514,513,2,3621406,3555505,239725,3861131,3795230,81.99633163,80.59683489,314
09/11/2021,Tue 09 Nov 2021,1373,1038,1,3622779,3556543,239726,3862505,3796269,82.02551038,80.61889946,315
10/11/2021,Wed 10 Nov 2021,1625,1323,0,3624404,3557866,239726,3864130,3797592,82.06001945,80.64699515,316
11/11/2021,Thu 11 Nov 2021,1397,1085,1,3625801,3558951,239727,3865528,3798678,82.08970787,80.67005783,317
12/11/2021,Fri 12 Nov 2021,1152,1117,5,3626953,3560068,239732,3866685,3799800,82.11427832,80.69388501,318
13/11/2021,Sat 13 Nov 2021,1411,1358,0,3628364,3561426,239732,3868096,3801158,82.14424281,80.72272398,319
14/11/2021,Sun 14 Nov 2021,1648,1800,0,3630012,3563226,239732,3869744,3802958,82.17924032,80.76094941,320
15/11/2021,Mon 15 Nov 2021,1245,568,0,3631257,3563794,239732,3870989,3803526,82.20567958,80.77301166,321
16/11/2021,Tue 16 Nov 2021,1319,1050,5,3632576,3564844,239737,3872313,3804581,82.23379651,80.79541601,322
17/11/2021,Wed 17 Nov 2021,1518,1088,0,3634094,3565932,239737,3873831,3805669,82.26603329,80.81852116,323
18/11/2021,Thu 18 Nov 2021,1665,2474,5,3635759,3568406,239742,3875501,3808148,82.30149799,80.87116607,324
19/11/2021,Fri 19 Nov 2021,1183,1525,0,3636942,3569931,239742,3876684,3809673,82.32662059,80.9035515,325
20/11/2021,Sat 20 Nov 2021,1540,2922,11,3638482,3572853,239753,3878235,3812606,82.35955817,80.96583772,326
21/11/2021,Sun 21 Nov 2021,1788,2752,0,3640270,3575605,239753,3880023,3815358,82.39752877,81.02428016,327
22/11/2021,Mon 22 Nov 2021,710,491,2,3640980,3576096,239755,3880735,3815851,82.41264905,81.03474968,328
23/11/2021,Tue 23 Nov 2021,2162,1556,6,3643142,3577652,239761,3882903,3817413,82.45868946,81.06792086,329
24/11/2021,Wed 24 Nov 2021,1626,3119,2,3644768,3580771,239763,3884531,3820534,82.49326224,81.13419951,330
25/11/2021,Thu 25 Nov 2021,1002,1160,1,3645770,3581931,239764,3885534,3821695,82.5145623,81.15885491,331
26/11/2021,Fri 26 Nov 2021,1290,1076,12,3647060,3583007,239776,3886836,3822783,82.54221202,81.18196006,332
27/11/2021,Sat 27 Nov 2021,1226,1551,5,3648286,3584558,239781,3888067,3824339,82.56835397,81.21500382,333
28/11/2021,Sun 28 Nov 2021,1966,2251,0,3650252,3586809,239781,3890033,3826590,82.61010464,81.26280685,334
29/11/2021,Mon 29 Nov 2021,553,976,1,3650805,3587785,239782,3890587,3827567,82.62186958,81.28355476,335
30/11/2021,Tue 30 Nov 2021,1928,1620,6,3652733,3589405,239788,3892521,3829193,82.66294068,81.31808507,336
01/12/2021,Wed 01 Dec 2021,1083,1352,1,3653816,3590757,239789,3893605,3830546,82.68596088,81.34681785,337
02/12/2021,Thu 02 Dec 2021,1775,1398,0,3655591,3592155,239789,3895380,3831944,82.7236554,81.37650627,1
03/12/2021,Fri 03 Dec 2021,1044,1165,3,3656635,3593320,239792,3896427,3833112,82.74588986,81.40131033,2
04/12/2021,Sat 04 Dec 2021,1201,1695,0,3657836,3595015,239792,3897628,3834807,82.77139472,81.43730594,3
05/12/2021,Sun 05 Dec 2021,1348,1770,0,3659184,3596785,239792,3898976,3836577,82.80002132,81.47489428,4
06/12/2021,Mon 06 Dec 2021,936,1275,0,3660120,3598060,239792,3899912,3837852,82.81989855,81.50197063,5
07/12/2021,Tue 07 Dec 2021,485,730,1,3660605,3598790,239793,3900398,3838583,82.83021941,81.5174944,6
08/12/2021,Wed 08 Dec 2021,812,1488,0,3661417,3600278,239793,3901210,3840071,82.84746333,81.54909409,7
09/12/2021,Thu 09 Dec 2021,796,1186,0,3662213,3601464,239793,3902006,3841257,82.86436746,81.5742804,8
10/12/2021,Fri 10 Dec 2021,893,1592,1,3663106,3603056,239794,3902900,3842850,82.88335276,81.60810991,9
11/12/2021,Sat 11 Dec 2021,636,835,0,3663742,3603891,239794,3903536,3843685,82.89685908,81.62584226,10
12/12/2021,Sun 12 Dec 2021,691,1188,0,3664433,3605079,239794,3904227,3844873,82.9115334,81.65107104,11
13/12/2021,Mon 13 Dec 2021,722,1045,0,3665155,3606124,239794,3904949,3845918,82.92686604,81.67326303,12
14/12/2021,Tue 14 Dec 2021,631,1180,1,3665786,3607304,239795,3905581,3847099,82.94028742,81.69834316,13
15/12/2021,Wed 15 Dec 2021,796,1228,1,3666582,3608532,239796,3906378,3848328,82.95721279,81.72444264,14
16/12/2021,Thu 16 Dec 2021,1065,1516,7,3667647,3610048,239803,3907450,3849851,82.97997816,81.7567856,15
17/12/2021,Fri 17 Dec 2021,1212,2434,1,3668859,3612482,239804,3908663,3852286,83.00573785,81.80849611,16
18/12/2021,Sat 18 Dec 2021,1266,1168,0,3670125,3613650,239804,3909929,3853454,83.03262307,81.83330017,17
19/12/2021,Sun 19 Dec 2021,558,877,0,3670683,3614527,239804,3910487,3854331,83.04447295,81.85192445,18
20/12/2021,Mon 20 Dec 2021,541,589,0,3671224,3615116,239804,3911028,3854920,83.05596182,81.86443266,19
21/12/2021,Tue 21 Dec 2021,1468,1775,3,3672692,3616891,239807,3912499,3856698,83.08720049,81.90219089,20
22/12/2021,Wed 22 Dec 2021,1239,1549,2,3673931,3618440,239809,3913740,3858249,83.1135548,81.93512847,21
23/12/2021,Thu 23 Dec 2021,965,1340,0,3674896,3619780,239809,3914705,3859589,83.13404788,81.96358518,22
24/12/2021,Fri 24 Dec 2021,102,137,0,3674998,3619917,239809,3914807,3859726,83.13621399,81.96649456,23
25/12/2021,Sat 25 Dec 2021,1,0,0,3674999,3619917,239809,3914808,3859726,83.13623522,81.96649456,24
26/12/2021,Sun 26 Dec 2021,10,6,0,3675009,3619923,239809,3914818,3859732,83.13644759,81.96662198,25
27/12/2021,Mon 27 Dec 2021,388,581,0,3675397,3620504,239809,3915206,3860313,83.14468729,81.9789603,26
28/12/2021,Tue 28 Dec 2021,468,737,0,3675865,3621241,239809,3915674,3861050,83.1546259,81.99461149,27
29/12/2021,Wed 29 Dec 2021,1087,1277,0,3676952,3622518,239809,3916761,3862327,83.17770982,82.02173031,28
30/12/2021,Thu 30 Dec 2021,1073,1170,1,3678025,3623688,239810,3917835,3863498,83.20051766,82.04659807,29
31/12/2021,Fri 31 Dec 2021,721,1666,0,3678746,3625354,239810,3918556,3865164,83.21582907,82.08197783,30
01/01/2022,Sat 01 Jan 2022,69,96,0,3678815,3625450,239810,3918625,3865260,83.21729437,82.08401652,31
02/01/2022,Sun 02 Jan 2022,270,622,0,3679085,3626072,239810,3918895,3865882,83.22302819,82.09722553,32
03/01/2022,Mon 03 Jan 2022,3632,714,0,3682717,3626786,239810,3922527,3866596,83.30015861,82.11238829,33
04/01/2022,Tue 04 Jan 2022,1195,758,0,3683912,3627544,239810,3923722,3867354,83.32553605,82.12848544,34
05/01/2022,Wed 05 Jan 2022,2146,879,0,3686058,3628423,239810,3925868,3868233,83.37110926,82.14715219,35
06/01/2022,Thu 06 Jan 2022,2463,1660,1,3688521,3630083,239811,3928332,3869894,83.42343563,82.18242577,36
07/01/2022,Fri 07 Jan 2022,4850,761,0,3693371,3630844,239811,3933182,3870655,83.52643193,82.19858664,37
08/01/2022,Sat 08 Jan 2022,9791,730,1,3703162,3631574,239812,3942974,3871386,83.73437828,82.21411041,38
09/01/2022,Sun 09 Jan 2022,7115,664,0,3710277,3632238,239812,3950089,3872050,83.88547491,82.22821135,39
10/01/2022,Mon 10 Jan 2022,6654,487,0,3716931,3632725,239812,3956743,3872537,84.02678159,82.23855345,40
11/01/2022,Tue 11 Jan 2022,4772,1338,1,3721703,3634063,239813,3961516,3873876,84.12814269,82.26698892,41
12/01/2022,Wed 12 Jan 2022,7556,885,1,3729259,3634948,239814,3969073,3874762,84.28862579,82.28580433,42
13/01/2022,Thu 13 Jan 2022,7323,788,0,3736582,3635736,239814,3976396,3875550,84.44413958,82.30253857,43
14/01/2022,Fri 14 Jan 2022,10729,813,0,3747311,3636549,239814,3987125,3876363,84.67198439,82.31980373,44
15/01/2022,Sat 15 Jan 2022,8354,636,0,3755665,3637185,239814,3995479,3876999,84.84939286,82.33331004,45
16/01/2022,Sun 16 Jan 2022,6966,1212,1,3762631,3638397,239815,4002446,3878212,84.99734652,82.35906974,46
17/01/2022,Mon 17 Jan 2022,2562,545,0,3765193,3638942,239815,4005008,3878757,85.05175405,82.37064355,47
18/01/2022,Tue 18 Jan 2022,4060,427,3,3769253,3639369,239818,4009071,3879187,85.13803734,82.37977518,48
19/01/2022,Wed 19 Jan 2022,3481,607,0,3772734,3639976,239818,4012552,3879794,85.21196108,82.39266564,49
20/01/2022,Thu 20 Jan 2022,3689,919,1,3776423,3640895,239819,4016242,3880714,85.29032321,82.41220309,50
21/01/2022,Fri 21 Jan 2022,3251,961,0,3779674,3641856,239819,4019493,3881675,85.35936259,82.43261122,51
22/01/2022,Sat 22 Jan 2022,4271,636,0,3783945,3642492,239819,4023764,3882311,85.45006304,82.44611754,52
23/01/2022,Sun 23 Jan 2022,3092,677,0,3787037,3643169,239819,4026856,3882988,85.51572584,82.46049455,53
24/01/2022,Mon 24 Jan 2022,645,456,0,3787682,3643625,239819,4027501,3883444,85.52942328,82.47017832,54
25/01/2022,Tue 25 Jan 2022,697,1828,0,3788379,3645453,239819,4028198,3885272,85.54422502,82.50899837,55
26/01/2022,Wed 26 Jan 2022,699,880,0,3789078,3646333,239819,4028897,3886152,85.55906923,82.52768636,56
27/01/2022,Thu 27 Jan 2022,1273,1156,0,3790351,3647489,239819,4030170,3887308,85.5861031,82.55223558,57
28/01/2022,Fri 28 Jan 2022,1027,3083,0,3791378,3650572,239819,4031197,3890391,85.60791283,82.61770725,58
29/01/2022,Sat 29 Jan 2022,2325,3438,0,3793703,3654010,239819,4033522,3893829,85.65728735,82.69071782,59
30/01/2022,Sun 30 Jan 2022,1634,7535,0,3795337,3661545,239819,4035156,3901364,85.69198755,82.85073373,60
31/01/2022,Mon 31 Jan 2022,479,1373,0,3795816,3662918,239819,4035635,3902737,85.70215976,82.87989124,61
01/02/2022,Tue 01 Feb 2022,751,3401,1,3796567,3666319,239820,4036387,3906139,85.71812949,82.9521373,62
02/02/2022,Wed 02 Feb 2022,643,2980,0,3797210,3669299,239820,4037030,3909119,85.73178447,83.01542163,63
03/02/2022,Thu 03 Feb 2022,909,2418,1,3798119,3671717,239821,4037940,3911538,85.75110955,83.06679236,64
04/02/2022,Fri 04 Feb 2022,1167,6496,0,3799286,3678213,239821,4039107,3918034,85.77589237,83.20474369,65
05/02/2022,Sat 05 Feb 2022,1777,5743,0,3801063,3683956,239821,4040884,3923777,85.81362936,83.32670405,66
06/02/2022,Sun 06 Feb 2022,1408,7555,0,3802471,3691511,239821,4042292,3931332,85.84353014,83.48714468,67
07/02/2022,Mon 07 Feb 2022,433,1339,0,3802904,3692850,239821,4042725,3932671,85.85272548,83.51558015,68
08/02/2022,Tue 08 Feb 2022,898,1218,0,3803802,3694068,239821,4043623,3933889,85.87179573,83.54144603,69
09/02/2022,Wed 09 Feb 2022,1332,1755,0,3805134,3695823,239821,4044955,3935644,85.90008255,83.57871583,70
10/02/2022,Thu 10 Feb 2022,687,2530,0,3805821,3698353,239821,4045642,3938174,85.91467192,83.63244379,71
11/02/2022,Fri 11 Feb 2022,555,4905,0,3806376,3703258,239821,4046197,3943079,85.92645809,83.73660809,72
12/02/2022,Sat 12 Feb 2022,1396,5458,0,3807772,3708716,239821,4047593,3948537,85.95610404,83.85251609,73
13/02/2022,Sun 13 Feb 2022,1567,4706,0,3809339,3713422,239821,4049160,3953243,85.9893814,83.95245436,74
14/02/2022,Mon 14 Feb 2022,173,945,1,3809512,3714367,239822,4049334,3954189,85.99307652,83.97254395,75
15/02/2022,Tue 15 Feb 2022,645,802,1,3810157,3715169,239823,4049980,3954992,86.00679521,83.98959674,76
16/02/2022,Wed 16 Feb 2022,792,1777,0,3810949,3716946,239823,4050772,3956769,86.0236144,84.02733373,77
17/02/2022,Thu 17 Feb 2022,789,1181,2,3811738,3718127,239825,4051563,3957952,86.04041235,84.05245633,78
18/02/2022,Fri 18 Feb 2022,793,3272,0,3812531,3721399,239825,4052356,3961224,86.05725278,84.12194167,79
19/02/2022,Sat 19 Feb 2022,976,3545,0,3813507,3724944,239825,4053332,3964769,86.07797945,84.19722454,80
20/02/2022,Sun 20 Feb 2022,1366,3587,0,3814873,3728531,239825,4054698,3968356,86.10698831,84.27339933,81
21/02/2022,Mon 21 Feb 2022,250,989,1,3815123,3729520,239826,4054949,3969346,86.11231863,84.29442331,82
22/02/2022,Tue 22 Feb 2022,476,961,0,3815599,3730481,239826,4055425,3970307,86.12242714,84.31483145,83
23/02/2022,Wed 23 Feb 2022,824,1260,1,3816423,3731741,239827,4056250,3971568,86.13994713,84.34161048,84
24/02/2022,Thu 24 Feb 2022,658,1216,0,3817081,3732957,239827,4056908,3972784,86.15392064,84.36743389,85
25/02/2022,Fri 25 Feb 2022,688,1212,0,3817769,3734169,239827,4057596,3973996,86.16853125,84.39317234,86
26/02/2022,Sat 26 Feb 2022,956,2084,0,3818725,3736253,239827,4058552,3976080,86.1888332,84.4374289,87
27/02/2022,Sun 27 Feb 2022,670,1780,0,3819395,3738033,239827,4059222,3977860,86.20306156,84.4752296,88
28/02/2022,Mon 28 Feb 2022,82,422,0,3819477,3738455,239827,4059304,3978282,86.20480294,84.48419134,89
01/03/2022,Tue 01 Mar 2022,122,932,1,3819599,3739387,239828,4059427,3979215,86.20741501,84.50400486,90
02/03/2022,Wed 02 Mar 2022,200,985,2,3819799,3740372,239830,4059629,3980202,86.21170475,84.52496514,91
03/03/2022,Thu 03 Mar 2022,266,1264,0,3820065,3741636,239830,4059895,3981466,86.21735362,84.55180788,92
04/03/2022,Fri 04 Mar 2022,726,1484,2,3820791,3743120,239832,4060623,3982952,86.23281369,84.5833651,93
05/03/2022,Sat 05 Mar 2022,961,3331,0,3821752,3746451,239832,4061584,3986283,86.25322182,84.65410338,94
06/03/2022,Sun 06 Mar 2022,455,1915,0,3822207,3748366,239832,4062039,3988198,86.26288436,84.69477099,95
07/03/2022,Mon 07 Mar 2022,112,108,0,3822319,3748474,239832,4062151,3988306,86.26526283,84.69706452,96
08/03/2022,Tue 08 Mar 2022,117,479,0,3822436,3748953,239832,4062268,3988785,86.26774748,84.70723673,97
09/03/2022,Wed 09 Mar 2022,114,317,0,3822550,3749270,239832,4062382,3989102,86.27016843,84.71396866,98
10/03/2022,Thu 10 Mar 2022,252,495,0,3822802,3749765,239832,4062634,3989597,86.27551999,84.72448065,99
11/03/2022,Fri 11 Mar 2022,492,2153,0,3823294,3751918,239832,4063126,3991750,86.28596827,84.77020251,100
12/03/2022,Sat 12 Mar 2022,474,2377,2,3823768,3754295,239834,4063602,3994129,86.29607678,84.82072379,101
13/03/2022,Sun 13 Mar 2022,362,1078,0,3824130,3755373,239834,4063964,3995207,86.30376433,84.84361658,102
14/03/2022,Mon 14 Mar 2022,99,107,0,3824229,3755480,239834,4064063,3995314,86.30586673,84.84588887,103
15/03/2022,Tue 15 Mar 2022,217,741,1,3824446,3756221,239835,4064281,3996056,86.31049626,84.86164624,104
16/03/2022,Wed 16 Mar 2022,187,779,1,3824633,3757000,239836,4064469,3996836,86.31448869,84.87821059,105
17/03/2022,Thu 17 Mar 2022,1,0,0,3824634,3757000,239836,4064470,3996836,86.31450993,84.87821059,106
18/03/2022,Fri 18 Mar 2022,2,6,0,3824636,3757006,239836,4064472,3996842,86.3145524,84.87833801,107
19/03/2022,Sat 19 Mar 2022,741,2774,0,3825377,3759780,239836,4065213,3999616,86.33028854,84.93724765,108
20/03/2022,Sun 20 Mar 2022,387,1390,0,3825764,3761170,239836,4065600,4001006,86.338507,84.96676617,109
21/03/2022,Mon 21 Mar 2022,58,94,0,3825822,3761264,239836,4065658,4001100,86.33973871,84.96876239,110
22/03/2022,Tue 22 Mar 2022,161,560,3,3825983,3761824,239839,4065822,4001663,86.34322147,84.98071846,111
